WHTWHTWHT -> sixsixsix
WHTWHTVTC -> sixsixtwo
WHTWHTACM -> sixsixone
WHTVTCWHT -> sixtwosix
WHTVTCVTC -> sixtwotwo
WHTVTCACM -> sixtwoone
WHTACMWHT -> sixonesix
WHTACMVTC -> sixonetwo
WHTACMACM -> sixoneone
VTCWHTWHT -> twosixsix
VTCWHTVTC -> twosixtwo
VTCWHTACM -> twosixone
VTCVTCWHT -> twotwosix
VTCVTCVTC -> twotwotwo
VTCVTCACM -> twotwoone
VTCACMWHT -> twoonesix
VTCACMVTC -> twoonetwo
VTCACMACM -> twooneone
ACMWHTWHT -> onesixsix
ACMWHTVTC -> onesixtwo
ACMWHTACM -> onesixone
ACMVTCWHT -> onetwosix
ACMVTCVTC -> onetwotwo
ACMVTCACM -> onetwoone
ACMACMWHT -> oneonesix
ACMACMVTC -> oneonetwo
ACMACMACM -> oneoneone

WHTWHTWHT -> sixsixsix
WHTWHTVTC -> sixsixtwo
WHTWHTACM -> sixsixone
WHTVTCWHT -> sixtwosix
WHTVTCVTC -> sixtwotwo
WHTVTCACM -> sixtwoone
WHTACMWHT -> sixonesix
WHTACMVTC -> sixonetwo
WHTACMACM -> sixoneone
VTCWHTWHT -> twosixsix
VTCWHTVTC -> twosixtwo
VTCWHTACM -> twosixone
VTCVTCWHT -> twotwosix
VTCVTCVTC -> twotwotwo
VTCVTCACM -> twotwoone
VTCACMWHT -> twoonesix
VTCACMVTC -> twoonetwo
VTCACMACM -> twooneone
ACMWHTWHT -> onesixsix
ACMWHTVTC -> onesixtwo
ACMWHTACM -> onesixone
ACMVTCWHT -> onetwosix
ACMVTCVTC -> onetwotwo
ACMVTCACM -> onetwoone
ACMACMWHT -> oneonesix
ACMACMVTC -> oneonetwo
ACMACMACM -> oneoneone

VSVVKAXAAPFCFFU -> eighteighteight
VSVVKAXAAPRGQIA -> eighteightseven
VSVVKAXAAPQDUIJ -> eighteightthree
VSVVKMBLDVFCFFU -> eightseveneight
VSVVKMBLDVRGQIA -> eightsevenseven
VSVVKMBLDVQDUIJ -> eightseventhree
VSVVKLYPDEFCFFU -> eightthreeeight
VSVVKLYPDERGQIA -> eightthreeseven
VSVVKLYPDEQDUIJ -> eightthreethree
HWGYQAXAAPFCFFU -> seveneighteight
HWGYQAXAAPRGQIA -> seveneightseven
HWGYQAXAAPQDUIJ -> seveneightthree
HWGYQMBLDVFCFFU -> sevenseveneight
HWGYQMBLDVRGQIA -> sevensevenseven
HWGYQMBLDVQDUIJ -> sevenseventhree
HWGYQLYPDEFCFFU -> seventhreeeight
HWGYQLYPDERGQIA -> seventhreeseven
HWGYQLYPDEQDUIJ -> seventhreethree
GTKYZAXAAPFCFFU -> threeeighteight
GTKYZAXAAPRGQIA -> threeeightseven
GTKYZAXAAPQDUIJ -> threeeightthree
GTKYZMBLDVFCFFU -> threeseveneight
GTKYZMBLDVRGQIA -> threesevenseven
GTKYZMBLDVQDUIJ -> threeseventhree
GTKYZLYPDEFCFFU -> threethreeeight
GTKYZLYPDERGQIA -> threethreeseven
GTKYZLYPDEQDUIJ -> threethreethree

RCPWRCUYMUF -> nineninesix
RCPWRCUYLGO -> nineninetwo
RCPWRCUYQPY -> ninenineone
RCPWMCKPWPY -> ninesixnine
RCPWMCKXWHY -> ninesixfive
RCPWMCKXQIL -> ninesixfour
RCPWMCKDALO -> ninesixzero
RCPWZCMYMUF -> ninefivesix
RCPWZCMYLGO -> ninefivetwo
RCPWZCMYQPY -> ninefiveone
RCPWZWNLMUF -> ninefoursix
RCPWZWNLLGO -> ninefourtwo
RCPWZWNLQPY -> ninefourone
RCPWLOTPWPY -> ninetwonine
RCPWLOTXWHY -> ninetwofive
RCPWLOTXQIL -> ninetwofour
RCPWLOTDALO -> ninetwozero
RCPWQXDPWPY -> nineonenine
RCPWQXDXWHY -> nineonefive
RCPWQXDXQIL -> nineonefour
RCPWQXDDALO -> nineonezero
RCPWFGQOMUF -> ninezerosix
RCPWFGQOLGO -> ninezerotwo
RCPWFGQOQPY -> ninezeroone
ACWTLSZFMUF -> eightsixsix
ACWTLSZFLGO -> eightsixtwo
ACWTLSZFQPY -> eightsixone
ACWTLRLOMUF -> eighttwosix
ACWTLRLOLGO -> eighttwotwo
ACWTLRLOQPY -> eighttwoone
ACWTLWUYMUF -> eightonesix
ACWTLWUYLGO -> eightonetwo
ACWTLWUYQPY -> eightoneone
MGHWRSZFMUF -> sevensixsix
MGHWRSZFLGO -> sevensixtwo
MGHWRSZFQPY -> sevensixone
MGHWRRLOMUF -> seventwosix
MGHWRRLOLGO -> seventwotwo
MGHWRRLOQPY -> seventwoone
MGHWRWUYMUF -> sevenonesix
MGHWRWUYLGO -> sevenonetwo
MGHWRWUYQPY -> sevenoneone
MCFNWXDPWPY -> sixninenine
MCFNWXDXWHY -> sixninefive
MCFNWXDXQIL -> sixninefour
MCFNWXDDALO -> sixninezero
MCFWWEAJMUF -> sixeightsix
MCFWWEAJLGO -> sixeighttwo
MCFWWEAJQPY -> sixeightone
MCFIAPDPMUF -> sixsevensix
MCFIAPDPLGO -> sixseventwo
MCFIAPDPQPY -> sixsevenone
MCFIWNDUYVJ -> sixsixeight
MCFIWNPYJYP -> sixsixseven
MCFIWNOVNYY -> sixsixthree
MCFVWPDPWPY -> sixfivenine
MCFVWPDXWHY -> sixfivefive
MCFVWPDXQIL -> sixfivefour
MCFVWPDDALO -> sixfivezero
MCFVQQQPWPY -> sixfournine
MCFVQQQXWHY -> sixfourfive
MCFVQQQXQIL -> sixfourfour
MCFVQQQDALO -> sixfourzero
MCFHXTDYMUF -> sixthreesix
MCFHXTDYLGO -> sixthreetwo
MCFHXTDYQPY -> sixthreeone
MCFHIWDUYVJ -> sixtwoeight
MCFHIWPYJYP -> sixtwoseven
MCFHIWOVNYY -> sixtwothree
MCFMRGDUYVJ -> sixoneeight
MCFMRGPYJYP -> sixoneseven
MCFMRGOVNYY -> sixonethree
MCFBATTPWPY -> sixzeronine
MCFBATTXWHY -> sixzerofive
MCFBATTXQIL -> sixzerofour
MCFBATTDALO -> sixzerozero
ZCHWRCUYMUF -> fiveninesix
ZCHWRCUYLGO -> fiveninetwo
ZCHWRCUYQPY -> fivenineone
ZCHWMCKPWPY -> fivesixnine
ZCHWMCKXWHY -> fivesixfive
ZCHWMCKXQIL -> fivesixfour
ZCHWMCKDALO -> fivesixzero
ZCHWZCMYMUF -> fivefivesix
ZCHWZCMYLGO -> fivefivetwo
ZCHWZCMYQPY -> fivefiveone
ZCHWZWNLMUF -> fivefoursix
ZCHWZWNLLGO -> fivefourtwo
ZCHWZWNLQPY -> fivefourone
ZCHWLOTPWPY -> fivetwonine
ZCHWLOTXWHY -> fivetwofive
ZCHWLOTXQIL -> fivetwofour
ZCHWLOTDALO -> fivetwozero
ZCHWQXDPWPY -> fiveonenine
ZCHWQXDXWHY -> fiveonefive
ZCHWQXDXQIL -> fiveonefour
ZCHWQXDDALO -> fiveonezero
ZCHWFGQOMUF -> fivezerosix
ZCHWFGQOLGO -> fivezerotwo
ZCHWFGQOQPY -> fivezeroone
ZWIJRCUYMUF -> fourninesix
ZWIJRCUYLGO -> fourninetwo
ZWIJRCUYQPY -> fournineone
ZWIJMCKPWPY -> foursixnine
ZWIJMCKXWHY -> foursixfive
ZWIJMCKXQIL -> foursixfour
ZWIJMCKDALO -> foursixzero
ZWIJZCMYMUF -> fourfivesix
ZWIJZCMYLGO -> fourfivetwo
ZWIJZCMYQPY -> fourfiveone
ZWIJZWNLMUF -> fourfoursix
ZWIJZWNLLGO -> fourfourtwo
ZWIJZWNLQPY -> fourfourone
ZWIJLOTPWPY -> fourtwonine
ZWIJLOTXWHY -> fourtwofive
ZWIJLOTXQIL -> fourtwofour
ZWIJLOTDALO -> fourtwozero
ZWIJQXDPWPY -> fouronenine
ZWIJQXDXWHY -> fouronefive
ZWIJQXDXQIL -> fouronefour
ZWIJQXDDALO -> fouronezero
ZWIJFGQOMUF -> fourzerosix
ZWIJFGQOLGO -> fourzerotwo
ZWIJFGQOQPY -> fourzeroone
LDLWASZFMUF -> threesixsix
LDLWASZFLGO -> threesixtwo
LDLWASZFQPY -> threesixone
LDLWARLOMUF -> threetwosix
LDLWARLOLGO -> threetwotwo
LDLWARLOQPY -> threetwoone
LDLWAWUYMUF -> threeonesix
LDLWAWUYLGO -> threeonetwo
LDLWAWUYQPY -> threeoneone
LOONWXDPWPY -> twoninenine
LOONWXDXWHY -> twoninefive
LOONWXDXQIL -> twoninefour
LOONWXDDALO -> twoninezero
LOOWWEAJMUF -> twoeightsix
LOOWWEAJLGO -> twoeighttwo
LOOWWEAJQPY -> twoeightone
LOOIAPDPMUF -> twosevensix
LOOIAPDPLGO -> twoseventwo
LOOIAPDPQPY -> twosevenone
LOOIWNDUYVJ -> twosixeight
LOOIWNPYJYP -> twosixseven
LOOIWNOVNYY -> twosixthree
LOOVWPDPWPY -> twofivenine
LOOVWPDXWHY -> twofivefive
LOOVWPDXQIL -> twofivefour
LOOVWPDDALO -> twofivezero
LOOVQQQPWPY -> twofournine
LOOVQQQXWHY -> twofourfive
LOOVQQQXQIL -> twofourfour
LOOVQQQDALO -> twofourzero
LOOHXTDYMUF -> twothreesix
LOOHXTDYLGO -> twothreetwo
LOOHXTDYQPY -> twothreeone
LOOHIWDUYVJ -> twotwoeight
LOOHIWPYJYP -> twotwoseven
LOOHIWOVNYY -> twotwothree
LOOMRGDUYVJ -> twooneeight
LOOMRGPYJYP -> twooneseven
LOOMRGOVNYY -> twoonethree
LOOBATTPWPY -> twozeronine
LOOBATTXWHY -> twozerofive
LOOBATTXQIL -> twozerofour
LOOBATTDALO -> twozerozero
QXYNWXDPWPY -> oneninenine
QXYNWXDXWHY -> oneninefive
QXYNWXDXQIL -> oneninefour
QXYNWXDDALO -> oneninezero
QXYWWEAJMUF -> oneeightsix
QXYWWEAJLGO -> oneeighttwo
QXYWWEAJQPY -> oneeightone
QXYIAPDPMUF -> onesevensix
QXYIAPDPLGO -> oneseventwo
QXYIAPDPQPY -> onesevenone
QXYIWNDUYVJ -> onesixeight
QXYIWNPYJYP -> onesixseven
QXYIWNOVNYY -> onesixthree
QXYVWPDPWPY -> onefivenine
QXYVWPDXWHY -> onefivefive
QXYVWPDXQIL -> onefivefour
QXYVWPDDALO -> onefivezero
QXYVQQQPWPY -> onefournine
QXYVQQQXWHY -> onefourfive
QXYVQQQXQIL -> onefourfour
QXYVQQQDALO -> onefourzero
QXYHXTDYMUF -> onethreesix
QXYHXTDYLGO -> onethreetwo
QXYHXTDYQPY -> onethreeone
QXYHIWDUYVJ -> onetwoeight
QXYHIWPYJYP -> onetwoseven
QXYHIWOVNYY -> onetwothree
QXYMRGDUYVJ -> oneoneeight
QXYMRGPYJYP -> oneoneseven
QXYMRGOVNYY -> oneonethree
QXYBATTPWPY -> onezeronine
QXYBATTXWHY -> onezerofive
QXYBATTXQIL -> onezerofour
QXYBATTDALO -> onezerozero
FGLMRCUYMUF -> zeroninesix
FGLMRCUYLGO -> zeroninetwo
FGLMRCUYQPY -> zeronineone
FGLMMCKPWPY -> zerosixnine
FGLMMCKXWHY -> zerosixfive
FGLMMCKXQIL -> zerosixfour
FGLMMCKDALO -> zerosixzero
FGLMZCMYMUF -> zerofivesix
FGLMZCMYLGO -> zerofivetwo
FGLMZCMYQPY -> zerofiveone
FGLMZWNLMUF -> zerofoursix
FGLMZWNLLGO -> zerofourtwo
FGLMZWNLQPY -> zerofourone
FGLMLOTPWPY -> zerotwonine
FGLMLOTXWHY -> zerotwofive
FGLMLOTXQIL -> zerotwofour
FGLMLOTDALO -> zerotwozero
FGLMQXDPWPY -> zeroonenine
FGLMQXDXWHY -> zeroonefive
FGLMQXDXQIL -> zeroonefour
FGLMQXDDALO -> zeroonezero
FGLMFGQOMUF -> zerozerosix
FGLMFGQOLGO -> zerozerotwo
FGLMFGQOQPY -> zerozeroone

EUREPJVNYULVL -> ninenineeight
EUREPJVNKYWYR -> ninenineseven
EUREPJVNJVAYA -> nineninethree
EUREYJCKJPJPA -> nineeightnine
EUREYJCKJXJHA -> nineeightfive
EUREYJCKJXDIN -> nineeightfour
EUREYJCKJDNLQ -> nineeightzero
EUREKNNNPPJPA -> ninesevennine
EUREKNNNPXJHA -> ninesevenfive
EUREKNNNPXDIN -> ninesevenfour
EUREKNNNPDNLQ -> ninesevenzero
EUREXJNNYULVL -> ninefiveeight
EUREXJNNKYWYR -> ninefiveseven
EUREXJNNJVAYA -> ninefivethree
EUREXDOAYULVL -> ninefoureight
EUREXDOAKYWYR -> ninefourseven
EUREXDOAJVAYA -> ninefourthree
EUREJKRNYPJPA -> ninethreenine
EUREJKRNYXJHA -> ninethreefive
EUREJKRNYXDIN -> ninethreefour
EUREJKRNYDNLQ -> ninethreezero
EUREDNRDYULVL -> ninezeroeight
EUREDNRDKYWYR -> ninezeroseven
EUREDNRDJVAYA -> ninezerothree
NUYBJEAEYPJPA -> eightninenine
NUYBJEAEYXJHA -> eightninefive
NUYBJEAEYXDIN -> eightninefour
NUYBJEAEYDNLQ -> eightninezero
NUYBJNALVJZUH -> eighteightsix
NUYBJNALVJYGQ -> eighteighttwo
NUYBJNALVJDPA -> eighteightone
NUYBJZEWYPZUH -> eightsevensix
NUYBJZEWYPYGQ -> eightseventwo
NUYBJZEWYPDPA -> eightsevenone
NUYBJZAUYULVL -> eightsixeight
NUYBJZAUKYWYR -> eightsixseven
NUYBJZAUJVAYA -> eightsixthree
NUYBJMAWYPJPA -> eightfivenine
NUYBJMAWYXJHA -> eightfivefive
NUYBJMAWYXDIN -> eightfivefour
NUYBJMAWYDNLQ -> eightfivezero
NUYBJMUXLPJPA -> eightfournine
NUYBJMUXLXJHA -> eightfourfive
NUYBJMUXLXDIN -> eightfourfour
NUYBJMUXLDNLQ -> eightfourzero
NUYBJYBAYYZUH -> eightthreesix
NUYBJYBAYYYGQ -> eightthreetwo
NUYBJYBAYYDPA -> eightthreeone
NUYBJYMDYULVL -> eighttwoeight
NUYBJYMDKYWYR -> eighttwoseven
NUYBJYMDJVAYA -> eighttwothree
NUYBJDVNYULVL -> eightoneeight
NUYBJDVNKYWYR -> eightoneseven
NUYBJDVNJVAYA -> eightonethree
NUYBJSEAOPJPA -> eightzeronine
NUYBJSEAOXJHA -> eightzerofive
NUYBJSEAOXDIN -> eightzerofour
NUYBJSEAODNLQ -> eightzerozero
ZYJEPEAEYPJPA -> sevenninenine
ZYJEPEAEYXJHA -> sevenninefive
ZYJEPEAEYXDIN -> sevenninefour
ZYJEPEAEYDNLQ -> sevenninezero
ZYJEPNALVJZUH -> seveneightsix
ZYJEPNALVJYGQ -> seveneighttwo
ZYJEPNALVJDPA -> seveneightone
ZYJEPZEWYPZUH -> sevensevensix
ZYJEPZEWYPYGQ -> sevenseventwo
ZYJEPZEWYPDPA -> sevensevenone
ZYJEPZAUYULVL -> sevensixeight
ZYJEPZAUKYWYR -> sevensixseven
ZYJEPZAUJVAYA -> sevensixthree
ZYJEPMAWYPJPA -> sevenfivenine
ZYJEPMAWYXJHA -> sevenfivefive
ZYJEPMAWYXDIN -> sevenfivefour
ZYJEPMAWYDNLQ -> sevenfivezero
ZYJEPMUXLPJPA -> sevenfournine
ZYJEPMUXLXJHA -> sevenfourfive
ZYJEPMUXLXDIN -> sevenfourfour
ZYJEPMUXLDNLQ -> sevenfourzero
ZYJEPYBAYYZUH -> seventhreesix
ZYJEPYBAYYYGQ -> seventhreetwo
ZYJEPYBAYYDPA -> seventhreeone
ZYJEPYMDYULVL -> seventwoeight
ZYJEPYMDKYWYR -> seventwoseven
ZYJEPYMDJVAYA -> seventwothree
ZYJEPDVNYULVL -> sevenoneeight
ZYJEPDVNKYWYR -> sevenoneseven
ZYJEPDVNJVAYA -> sevenonethree
ZYJEPSEAOPJPA -> sevenzeronine
ZYJEPSEAOXJHA -> sevenzerofive
ZYJEPSEAOXDIN -> sevenzerofour
ZYJEPSEAODNLQ -> sevenzerozero
ZUHEULBYYULVL -> sixeighteight
ZUHEULBYKYWYR -> sixeightseven
ZUHEULBYJVAYA -> sixeightthree
ZUHQYWEEYULVL -> sixseveneight
ZUHQYWEEKYWYR -> sixsevenseven
ZUHQYWEEJVAYA -> sixseventhree
ZUHPVAENYULVL -> sixthreeeight
ZUHPVAENKYWYR -> sixthreeseven
ZUHPVAENJVAYA -> sixthreethree
MUJEPJVNYULVL -> fivenineeight
MUJEPJVNKYWYR -> fivenineseven
MUJEPJVNJVAYA -> fiveninethree
MUJEYJCKJPJPA -> fiveeightnine
MUJEYJCKJXJHA -> fiveeightfive
MUJEYJCKJXDIN -> fiveeightfour
MUJEYJCKJDNLQ -> fiveeightzero
MUJEKNNNPPJPA -> fivesevennine
MUJEKNNNPXJHA -> fivesevenfive
MUJEKNNNPXDIN -> fivesevenfour
MUJEKNNNPDNLQ -> fivesevenzero
MUJEXJNNYULVL -> fivefiveeight
MUJEXJNNKYWYR -> fivefiveseven
MUJEXJNNJVAYA -> fivefivethree
MUJEXDOAYULVL -> fivefoureight
MUJEXDOAKYWYR -> fivefourseven
MUJEXDOAJVAYA -> fivefourthree
MUJEJKRNYPJPA -> fivethreenine
MUJEJKRNYXJHA -> fivethreefive
MUJEJKRNYXDIN -> fivethreefour
MUJEJKRNYDNLQ -> fivethreezero
MUJEDNRDYULVL -> fivezeroeight
MUJEDNRDKYWYR -> fivezeroseven
MUJEDNRDJVAYA -> fivezerothree
MOKRPJVNYULVL -> fournineeight
MOKRPJVNKYWYR -> fournineseven
MOKRPJVNJVAYA -> fourninethree
MOKRYJCKJPJPA -> foureightnine
MOKRYJCKJXJHA -> foureightfive
MOKRYJCKJXDIN -> foureightfour
MOKRYJCKJDNLQ -> foureightzero
MOKRKNNNPPJPA -> foursevennine
MOKRKNNNPXJHA -> foursevenfive
MOKRKNNNPXDIN -> foursevenfour
MOKRKNNNPDNLQ -> foursevenzero
MOKRXJNNYULVL -> fourfiveeight
MOKRXJNNKYWYR -> fourfiveseven
MOKRXJNNJVAYA -> fourfivethree
MOKRXDOAYULVL -> fourfoureight
MOKRXDOAKYWYR -> fourfourseven
MOKRXDOAJVAYA -> fourfourthree
MOKRJKRNYPJPA -> fourthreenine
MOKRJKRNYXJHA -> fourthreefive
MOKRJKRNYXDIN -> fourthreefour
MOKRJKRNYDNLQ -> fourthreezero
MOKRDNRDYULVL -> fourzeroeight
MOKRDNRDKYWYR -> fourzeroseven
MOKRDNRDJVAYA -> fourzerothree
YVNEYEAEYPJPA -> threeninenine
YVNEYEAEYXJHA -> threeninefive
YVNEYEAEYXDIN -> threeninefour
YVNEYEAEYDNLQ -> threeninezero
YVNEYNALVJZUH -> threeeightsix
YVNEYNALVJYGQ -> threeeighttwo
YVNEYNALVJDPA -> threeeightone
YVNEYZEWYPZUH -> threesevensix
YVNEYZEWYPYGQ -> threeseventwo
YVNEYZEWYPDPA -> threesevenone
YVNEYZAUYULVL -> threesixeight
YVNEYZAUKYWYR -> threesixseven
YVNEYZAUJVAYA -> threesixthree
YVNEYMAWYPJPA -> threefivenine
YVNEYMAWYXJHA -> threefivefive
YVNEYMAWYXDIN -> threefivefour
YVNEYMAWYDNLQ -> threefivezero
YVNEYMUXLPJPA -> threefournine
YVNEYMUXLXJHA -> threefourfive
YVNEYMUXLXDIN -> threefourfour
YVNEYMUXLDNLQ -> threefourzero
YVNEYYBAYYZUH -> threethreesix
YVNEYYBAYYYGQ -> threethreetwo
YVNEYYBAYYDPA -> threethreeone
YVNEYYMDYULVL -> threetwoeight
YVNEYYMDKYWYR -> threetwoseven
YVNEYYMDJVAYA -> threetwothree
YVNEYDVNYULVL -> threeoneeight
YVNEYDVNKYWYR -> threeoneseven
YVNEYDVNJVAYA -> threeonethree
YVNEYSEAOPJPA -> threezeronine
YVNEYSEAOXJHA -> threezerofive
YVNEYSEAOXDIN -> threezerofour
YVNEYSEAODNLQ -> threezerozero
YGQEULBYYULVL -> twoeighteight
YGQEULBYKYWYR -> twoeightseven
YGQEULBYJVAYA -> twoeightthree
YGQQYWEEYULVL -> twoseveneight
YGQQYWEEKYWYR -> twosevenseven
YGQQYWEEJVAYA -> twoseventhree
YGQPVAENYULVL -> twothreeeight
YGQPVAENKYWYR -> twothreeseven
YGQPVAENJVAYA -> twothreethree
DPAEULBYYULVL -> oneeighteight
DPAEULBYKYWYR -> oneeightseven
DPAEULBYJVAYA -> oneeightthree
DPAQYWEEYULVL -> oneseveneight
DPAQYWEEKYWYR -> onesevenseven
DPAQYWEEJVAYA -> oneseventhree
DPAPVAENYULVL -> onethreeeight
DPAPVAENKYWYR -> onethreeseven
DPAPVAENJVAYA -> onethreethree
SYNUPJVNYULVL -> zeronineeight
SYNUPJVNKYWYR -> zeronineseven
SYNUPJVNJVAYA -> zeroninethree
SYNUYJCKJPJPA -> zeroeightnine
SYNUYJCKJXJHA -> zeroeightfive
SYNUYJCKJXDIN -> zeroeightfour
SYNUYJCKJDNLQ -> zeroeightzero
SYNUKNNNPPJPA -> zerosevennine
SYNUKNNNPXJHA -> zerosevenfive
SYNUKNNNPXDIN -> zerosevenfour
SYNUKNNNPDNLQ -> zerosevenzero
SYNUXJNNYULVL -> zerofiveeight
SYNUXJNNKYWYR -> zerofiveseven
SYNUXJNNJVAYA -> zerofivethree
SYNUXDOAYULVL -> zerofoureight
SYNUXDOAKYWYR -> zerofourseven
SYNUXDOAJVAYA -> zerofourthree
SYNUJKRNYPJPA -> zerothreenine
SYNUJKRNYXJHA -> zerothreefive
SYNUJKRNYXDIN -> zerothreefour
SYNUJKRNYDNLQ -> zerothreezero
SYNUDNRDYULVL -> zerozeroeight
SYNUDNRDKYWYR -> zerozeroseven
SYNUDNRDJVAYA -> zerozerothree

MJFMYNZUJ -> sixsixsix
MJFMYNYGS -> sixsixtwo
MJFMYNDPC -> sixsixone
MJFLKWZUJ -> sixtwosix
MJFLKWYGS -> sixtwotwo
MJFLKWDPC -> sixtwoone
MJFQTGZUJ -> sixonesix
MJFQTGYGS -> sixonetwo
MJFQTGDPC -> sixoneone
LVOMYNZUJ -> twosixsix
LVOMYNYGS -> twosixtwo
LVOMYNDPC -> twosixone
LVOLKWZUJ -> twotwosix
LVOLKWYGS -> twotwotwo
LVOLKWDPC -> twotwoone
LVOQTGZUJ -> twoonesix
LVOQTGYGS -> twoonetwo
LVOQTGDPC -> twooneone
QEYMYNZUJ -> onesixsix
QEYMYNYGS -> onesixtwo
QEYMYNDPC -> onesixone
QEYLKWZUJ -> onetwosix
QEYLKWYGS -> onetwotwo
QEYLKWDPC -> onetwoone
QEYQTGZUJ -> oneonesix
QEYQTGYGS -> oneonetwo
QEYQTGDPC -> oneoneone

RUEEAWAVNAULDN -> nineeighteight
RUEEAWAVNMYWGT -> nineeightseven
RUEEAWAVNLVAGC -> nineeightthree
RUEEMALYTAULDN -> nineseveneight
RUEEMALYTMYWGT -> ninesevenseven
RUEEMALYTLVAGC -> nineseventhree
RUEELXPYCAULDN -> ninethreeeight
RUEELXPYCMYWGT -> ninethreeseven
RUEELXPYCLVAGC -> ninethreethree
AULBLRYPCAULDN -> eightnineeight
AULBLRYPCMYWGT -> eightnineseven
AULBLRYPCLVAGC -> eightninethree
AULBLAYWZLPJXC -> eighteightnine
AULBLAYWZLXJPC -> eighteightfive
AULBLAYWZLXDQP -> eighteightfour
AULBLAYWZLDNTS -> eighteightzero
AULBLMCHCRPJXC -> eightsevennine
AULBLMCHCRXJPC -> eightsevenfive
AULBLMCHCRXDQP -> eightsevenfour
AULBLMCHCRDNTS -> eightsevenzero
AULBLZYHCAULDN -> eightfiveeight
AULBLZYHCMYWGT -> eightfiveseven
AULBLZYHCLVAGC -> eightfivethree
AULBLZSIPAULDN -> eightfoureight
AULBLZSIPMYWGT -> eightfourseven
AULBLZSIPLVAGC -> eightfourthree
AULBLLZLCAPJXC -> eightthreenine
AULBLLZLCAXJPC -> eightthreefive
AULBLLZLCAXDQP -> eightthreefour
AULBLLZLCADNTS -> eightthreezero
AULBLFCLSAULDN -> eightzeroeight
AULBLFCLSMYWGT -> eightzeroseven
AULBLFCLSLVAGC -> eightzerothree
MYWERRYPCAULDN -> sevennineeight
MYWERRYPCMYWGT -> sevennineseven
MYWERRYPCLVAGC -> sevenninethree
MYWERAYWZLPJXC -> seveneightnine
MYWERAYWZLXJPC -> seveneightfive
MYWERAYWZLXDQP -> seveneightfour
MYWERAYWZLDNTS -> seveneightzero
MYWERMCHCRPJXC -> sevensevennine
MYWERMCHCRXJPC -> sevensevenfive
MYWERMCHCRXDQP -> sevensevenfour
MYWERMCHCRDNTS -> sevensevenzero
MYWERZYHCAULDN -> sevenfiveeight
MYWERZYHCMYWGT -> sevenfiveseven
MYWERZYHCLVAGC -> sevenfivethree
MYWERZSIPAULDN -> sevenfoureight
MYWERZSIPMYWGT -> sevenfourseven
MYWERZSIPLVAGC -> sevenfourthree
MYWERLZLCAPJXC -> seventhreenine
MYWERLZLCAXJPC -> seventhreefive
MYWERLZLCAXDQP -> seventhreefour
MYWERLZLCADNTS -> seventhreezero
MYWERFCLSAULDN -> sevenzeroeight
MYWERFCLSMYWGT -> sevenzeroseven
MYWERFCLSLVAGC -> sevenzerothree
ZUWEAWAVNAULDN -> fiveeighteight
ZUWEAWAVNMYWGT -> fiveeightseven
ZUWEAWAVNLVAGC -> fiveeightthree
ZUWEMALYTAULDN -> fiveseveneight
ZUWEMALYTMYWGT -> fivesevenseven
ZUWEMALYTLVAGC -> fiveseventhree
ZUWELXPYCAULDN -> fivethreeeight
ZUWELXPYCMYWGT -> fivethreeseven
ZUWELXPYCLVAGC -> fivethreethree
ZOXRAWAVNAULDN -> foureighteight
ZOXRAWAVNMYWGT -> foureightseven
ZOXRAWAVNLVAGC -> foureightthree
ZOXRMALYTAULDN -> fourseveneight
ZOXRMALYTMYWGT -> foursevenseven
ZOXRMALYTLVAGC -> fourseventhree
ZOXRLXPYCAULDN -> fourthreeeight
ZOXRLXPYCMYWGT -> fourthreeseven
ZOXRLXPYCLVAGC -> fourthreethree
LVAEARYPCAULDN -> threenineeight
LVAEARYPCMYWGT -> threenineseven
LVAEARYPCLVAGC -> threeninethree
LVAEAAYWZLPJXC -> threeeightnine
LVAEAAYWZLXJPC -> threeeightfive
LVAEAAYWZLXDQP -> threeeightfour
LVAEAAYWZLDNTS -> threeeightzero
LVAEAMCHCRPJXC -> threesevennine
LVAEAMCHCRXJPC -> threesevenfive
LVAEAMCHCRXDQP -> threesevenfour
LVAEAMCHCRDNTS -> threesevenzero
LVAEAZYHCAULDN -> threefiveeight
LVAEAZYHCMYWGT -> threefiveseven
LVAEAZYHCLVAGC -> threefivethree
LVAEAZSIPAULDN -> threefoureight
LVAEAZSIPMYWGT -> threefourseven
LVAEAZSIPLVAGC -> threefourthree
LVAEALZLCAPJXC -> threethreenine
LVAEALZLCAXJPC -> threethreefive
LVAEALZLCAXDQP -> threethreefour
LVAEALZLCADNTS -> threethreezero
LVAEAFCLSAULDN -> threezeroeight
LVAEAFCLSMYWGT -> threezeroseven
LVAEAFCLSLVAGC -> threezerothree
FYAUAWAVNAULDN -> zeroeighteight
FYAUAWAVNMYWGT -> zeroeightseven
FYAUAWAVNLVAGC -> zeroeightthree
FYAUMALYTAULDN -> zeroseveneight
FYAUMALYTMYWGT -> zerosevenseven
FYAUMALYTLVAGC -> zeroseventhree
FYAULXPYCAULDN -> zerothreeeight
FYAULXPYCMYWGT -> zerothreeseven
FYAULXPYCLVAGC -> zerothreethree

PWVNKCHKJL -> ninesixsix
PWVNKCHJVU -> ninesixtwo
PWVNKCHOEE -> ninesixone
PWVNJOQKJL -> ninetwosix
PWVNJOQJVU -> ninetwotwo
PWVNJOQOEE -> ninetwoone
PWVNOXAKJL -> nineonesix
PWVNOXAJVU -> nineonetwo
PWVNOXAOEE -> nineoneone
KWLEUXAKJL -> sixninesix
KWLEUXAJVU -> sixninetwo
KWLEUXAOEE -> sixnineone
KWLZUNRUEE -> sixsixnine
KWLZUNZUWE -> sixsixfive
KWLZUNZOXR -> sixsixfour
KWLZUNFYAU -> sixsixzero
KWLMUPAKJL -> sixfivesix
KWLMUPAJVU -> sixfivetwo
KWLMUPAOEE -> sixfiveone
KWLMOQNKJL -> sixfoursix
KWLMOQNJVU -> sixfourtwo
KWLMOQNOEE -> sixfourone
KWLYGWRUEE -> sixtwonine
KWLYGWZUWE -> sixtwofive
KWLYGWZOXR -> sixtwofour
KWLYGWFYAU -> sixtwozero
KWLDPGRUEE -> sixonenine
KWLDPGZUWE -> sixonefive
KWLDPGZOXR -> sixonefour
KWLDPGFYAU -> sixonezero
KWLSYTQKJL -> sixzerosix
KWLSYTQJVU -> sixzerotwo
KWLSYTQOEE -> sixzeroone
XWNNKCHKJL -> fivesixsix
XWNNKCHJVU -> fivesixtwo
XWNNKCHOEE -> fivesixone
XWNNJOQKJL -> fivetwosix
XWNNJOQJVU -> fivetwotwo
XWNNJOQOEE -> fivetwoone
XWNNOXAKJL -> fiveonesix
XWNNOXAJVU -> fiveonetwo
XWNNOXAOEE -> fiveoneone
XQOAKCHKJL -> foursixsix
XQOAKCHJVU -> foursixtwo
XQOAKCHOEE -> foursixone
XQOAJOQKJL -> fourtwosix
XQOAJOQJVU -> fourtwotwo
XQOAJOQOEE -> fourtwoone
XQOAOXAKJL -> fouronesix
XQOAOXAJVU -> fouronetwo
XQOAOXAOEE -> fouroneone
JIUEUXAKJL -> twoninesix
JIUEUXAJVU -> twoninetwo
JIUEUXAOEE -> twonineone
JIUZUNRUEE -> twosixnine
JIUZUNZUWE -> twosixfive
JIUZUNZOXR -> twosixfour
JIUZUNFYAU -> twosixzero
JIUMUPAKJL -> twofivesix
JIUMUPAJVU -> twofivetwo
JIUMUPAOEE -> twofiveone
JIUMOQNKJL -> twofoursix
JIUMOQNJVU -> twofourtwo
JIUMOQNOEE -> twofourone
JIUYGWRUEE -> twotwonine
JIUYGWZUWE -> twotwofive
JIUYGWZOXR -> twotwofour
JIUYGWFYAU -> twotwozero
JIUDPGRUEE -> twoonenine
JIUDPGZUWE -> twoonefive
JIUDPGZOXR -> twoonefour
JIUDPGFYAU -> twoonezero
JIUSYTQKJL -> twozerosix
JIUSYTQJVU -> twozerotwo
JIUSYTQOEE -> twozeroone
OREEUXAKJL -> oneninesix
OREEUXAJVU -> oneninetwo
OREEUXAOEE -> onenineone
OREZUNRUEE -> onesixnine
OREZUNZUWE -> onesixfive
OREZUNZOXR -> onesixfour
OREZUNFYAU -> onesixzero
OREMUPAKJL -> onefivesix
OREMUPAJVU -> onefivetwo
OREMUPAOEE -> onefiveone
OREMOQNKJL -> onefoursix
OREMOQNJVU -> onefourtwo
OREMOQNOEE -> onefourone
OREYGWRUEE -> onetwonine
OREYGWZUWE -> onetwofive
OREYGWZOXR -> onetwofour
OREYGWFYAU -> onetwozero
OREDPGRUEE -> oneonenine
OREDPGZUWE -> oneonefive
OREDPGZOXR -> oneonefour
OREDPGFYAU -> oneonezero
ORESYTQKJL -> onezerosix
ORESYTQJVU -> onezerotwo
ORESYTQOEE -> onezeroone
DARDKCHKJL -> zerosixsix
DARDKCHJVU -> zerosixtwo
DARDKCHOEE -> zerosixone
DARDJOQKJL -> zerotwosix
DARDJOQJVU -> zerotwotwo
DARDJOQOEE -> zerotwoone
DARDOXAKJL -> zeroonesix
DARDOXAJVU -> zeroonetwo
DARDOXAOEE -> zerooneone

